DAILYDGRADE-000000	yes , that's my only day off until Thursday .	ok , well , my friends and I are planning on going to the beach on Sunday . We tend to leave around noon whenever we go anywhere , so you could still sleep in . Do you want to come with us ?	ok . I ' ll be there in the afternoon .
DAILYDGRADE-000001	Hello , 332440 .	Oh hello , Sally . This is Dave Thomson here . Could I speak to Jim please ?	This is Jim , please .
DAILYDGRADE-000002	If only our company prescribe flex time .	The board has been considering introducing flex time .	But it ' s not a very high - worker , but it ' s not a very high - time job .
DAILYDGRADE-000003	Thank you so much . Does he read his e-mails daily ?	Yes . He usually replies immediately .	Oh , he ' s a man of the first person . He ' s a successful successful successful man .
DAILYDGRADE-000004	I'll take a little milk , but no sugar , please . Make sure you let the tea steep a few minutes before you take the tea bag out of the cup .	Ok . What do you think about our living room ?	It ' s a very good idea .
DAILYDGRADE-000005	I want to take a look at that home with the Open House flags out front .	What a wonderful neighborhood ! Can you find that house on our Open House list ?	I am sorry I can ' t go there .
DAILYDGRADE-000006	Take it easy . We are going to have our own baby . You should be happy .	Yeah , I know .	Well , you know .
DAILYDGRADE-000007	Wow ! Your calligraphy is very beautiful . It was worth the wait !	Thank you . Today I'm writing a kind of poem called a Chinese couplet .	It ' s so bad .
DAILYDGRADE-000008	Anything wrong with it ?	Yes . When I spread it out back home , I found this hole .	How do you think it is ?
DAILYDGRADE-000009	The service did not help the situation .	Is this a restaurant that you want to come back to ?	I am afraid I can ' t make it .
DAILYDGRADE-000010	Well , there will be charity performance on Saturday night . And also , there will be a solo concert by an opera star on Sunday night .	It's a good thing that I have choices here . Can you tell me about the one on Saturday ?	Sure , let ' s go to the concert with a night .
DAILYDGRADE-000011	What do you think about the equipment in our company ?	We have to equip our company with a network of work stations at every office and show room as soon as possible .	We have a lot of work , but we have to work overtime . We need to work with a company .
DAILYDGRADE-000012	I shouted it back of course .	Hold it , Mike . You won't accomplish anything by hollering at him , right ? You worked it all up till now . Why not wait until you cool down a bit ?	I ' ve been a little sick for a while . I was a little boy and I haven ' t lost my temper .
DAILYDGRADE-000013	What did they say ?	They said I need a new hard drive .	They are very good .
DAILYDGRADE-000014	That is right up my alley . You say party and I'm there .	Perfect . It will be open to the public and we anticipate roughly about five to seven hundred people .	Are you serious ?
DAILYDGRADE-000015	I can check that for you right now . Would you mind holding ?	Sure . No problem .	I ' m afraid I can ' t .
DAILYDGRADE-000016	Oh , your precious game . You watch the same game every year , and each year your beloved hometown team loses by at least three goals !	Oh no you didn't . You didn't just insult the Sals-bury Seals , did you ? Why don't you just . just go and return all of those stupid clothes and not come back until the sales are over ?	I ' m not so serious ! I ' m just gonna go to the game .
DAILYDGRADE-000017	I wasn't all that impressed by the food .	The service certainly could have been better .	What do you think of the food ?
DAILYDGRADE-000018	Me ? No way , keep him away from me , please .	Why are you acting so strange today ?	Because he ' s a little boy .
DAILYDGRADE-000019	Did you lend him a lot of money ?	Not much . I had to pay an unexpected bill , so I needed the money back .	I didn ' t pay attention to it .
DAILYDGRADE-000020	Here you are .	Thanks . What kind of stone is this ?	I ' m going to have a big fan of meat .
DAILYDGRADE-000021	Excuse me . Do you mind if I try this on ?	Not at all . The changing rooms are just this way .	I am sorry , but I ' m afraid I can ' t .
DAILYDGRADE-000022	Well , it's specially made of a platinum alloy , sir , and the lustre will never fade out .	I'II take them . Please wrap them up tor me and give me the receipt .	OK . I ' ll take it .
DAILYDGRADE-000023	That's for the phone calls you made from your room .	Can I pay with traveller's cheques ?	Yes , I have .
DAILYDGRADE-000024	Yes , I have been working in the Public Relations Section of a company in the past two years . I plan the advertising campaign and cooperate the work of artists and typographers . Sometimes I have to do the work of a specialist when there's something urgent .	Do you have any practical experience as a secretary ?	I ' m not familiar with the company , but I don ' t have any other questions . I ' m not familiar with the customer . I ' m afraid I can ' t do any other things .
DAILYDGRADE-000025	How long will the induction training be ?	About two weeks .	You ' re welcome .
DAILYDGRADE-000026	Yeah , about .	Do you know Chinese better now ?	I know . But I know you ' re a student now .
DAILYDGRADE-000027	Hum , Edward Norton , or something like that . Did you like him ?	Yes . He was excellent . They worked well together , don't you think ?	Yes , I was a little boy .
DAILYDGRADE-000028	What sort of job would you like to take ?	I prefer a sedentary job and I used to work as an operator .	What kind of job do you want ?
DAILYDGRADE-000029	Yes , I'd like a book about law .	Would you tell me the name of the book and the author ?	It ' s author author .
DAILYDGRADE-000030	I like the sound of that .	Yes , that is today's sale price .	I ' m sorry , but I didn ' t expect you to pay for it .
DAILYDGRADE-000031	Good morning .	What does the paper say ?	It means that you can only afford it .
DAILYDGRADE-000032	All right , can I have your passbook ?	Yes , here you go .	I want to go to the bank .
DAILYDGRADE-000033	I'm very sorry to hear that . May I have your name and room number , please ?	Yes , it's Yao Lan . Room 406 .	Thanks .
DAILYDGRADE-000034	I should tell you that I'm checking out in about 30 minutes .	I'm ready when you are , sir .	I ' m afraid I ' ll be back in a minute .
DAILYDGRADE-000035	Hello ! How do I get more amenities ?	I'm sorry , sir . I'm not sure I understand .	Well , sir , you are quite right .
DAILYDGRADE-000036	And they will yell back at you .	Yelling doesn't do any good .	I ' ll go .
DAILYDGRADE-000037	The traffic is not very heavy on this high way , is it ? So I'm sure we'll make it .	No , but we'Ve got a hurry . It will be the rush hour soon .	I ' m afraid we can ' t wait until the traffic jam .
DAILYDGRADE-000038	What style do you want ?	I want to buy a V-neck checked sweater , and it should be tight .	OK . Here you are .
DAILYDGRADE-000039	Mr . Smith , please .	Sorry , he is out .	I ' m sorry , Mr . Smith .
DAILYDGRADE-000040	Surely of course .	Here is the film . Can I get my pictures tomorrow ?	Sure . What is it ?
DAILYDGRADE-000041	I need to stay home tonight and finish my term paper .	OK . What about going to the movies on Friday night ?	I ' m not sure .
DAILYDGRADE-000042	Let me check . Yes , we have .	May I try it on ?	Here you are .
DAILYDGRADE-000043	And they're very dear , too .	They're on special offer today .	They ' re quite different , but they ' re not going to be able to get a raise .
DAILYDGRADE-000044	You can't come any earlier than that ?	I'm sorry . That's the only available time .	What time does the next time ?
DAILYDGRADE-000045	Hello .	Hi . It's Tony calling from the dentist's office . Is Lily there ?	Yes , he is .
DAILYDGRADE-000046	Excuse me . I have an appointment with Mr . Li at nine . May I come in ?	Yes , come in please . I am Mr . Li . You must be My Liu , right ?	Yes , I am . I am afraid I can ' t .
DAILYDGRADE-000047	You need a babysitter .	Yes , I'd ask Jill , the girl I've had before , but I need someone overnight . Maybe even for two nights .	I know , but I ' m a girl of my own friends .
DAILYDGRADE-000048	What is it ? What happened ?	I think someone is stalking me .	Yeah , I just got it . I just got it . I just got it .
DAILYDGRADE-000049	What is it used for ? I mean , why bother to get this special account ?	Group companies can use this to make their arrangement of funds flexible , when dealing with their subsidiaries .	What does the company have ?
DAILYDGRADE-000050	The boss wanted to pay Bob with stock options . But Bob didn't want to play that game again .	Again ?	I don ' t know . I don ' t know .
DAILYDGRADE-000051	Shall we drop in somewhere for a couple of drinks ?	That sounds like a good idea .	What do you mean ?
DAILYDGRADE-000052	Ah , some products are successful at home , but not be popular overseas .	That's because the fashion , taste and social customs and so on vary considerably .	I see . I ' ll look for you to find a job .
DAILYDGRADE-000053	How can you be so sure ?	I can tell form the way he spoke to us .	I see .
DAILYDGRADE-000054	You know , I fell in love with this house the first moment I laid eyes on it .	The style of the exterior is just what I'Ve been looking for !	Have you ever been to the windows ?
DAILYDGRADE-000055	I want to go traveling .	Do you have any where in mind ?	I ' m not sure .
DAILYDGRADE-000056	Not bad .	Say I've got two tickets for the concert this evening . Would you like to come with me ?	That ' s fine .
DAILYDGRADE-000057	With everything , with everybody , with all this !	A good suggestion for you . You need a holiday .	What ?
DAILYDGRADE-000058	Good afternoon . I come here specially to pick up my tickets . I booked it last month . This is my reservation note .	I am terribly sorry . You didn't come to reconfirm recently . You should have come to pick up your ticket three days ago since it's an international flight , any reservation without reconfirmation within 72 hours will be cancelled .	That ' s fine . We will have a reservation for us .
DAILYDGRADE-000059	Are these the clothes you want to have washed ?	Yes . When can I get them back ?	You can wash the clothes without clothes , and then you will be washed by the window .
DAILYDGRADE-000060	Exactly ! I searched on the web and found a couple of HMO's with low co-pays and good coverage . The deductibles are low , too .	Sounds good , although , do you think we can qualify for insurance ? Those insurance companies are real pirates when it comes to money .	If we are not , we should start to work overtime , we should start the rest .
DAILYDGRADE-000061	Then tell me something about your background .	My major was computer science when I was at college , and I am quite familiar with Visual C + + and Java language .	What ' s your computer qualifications ?
DAILYDGRADE-000062	Hi . What's your name ?	My name is Jung Min . What's your name ?	It ' s Snow .
DAILYDGRADE-000063	Great ! B , most of the items listed are available this year . I hope we can come to an agreement and sign the contracts , so as to enable our timely delivery .	That sounds good . But I have a proposal now .	We have a problem with your business . We will be ready by Thursday .
DAILYDGRADE-000064	Why don't you watch where you're going ?	Me ? You're the one who pulled out in front of me !	I ' m not sure .
DAILYDGRADE-000065	How much is that one ?	It's two hundred and eighty dollars .	That ' s good .
DAILYDGRADE-000066	I need to book a plane ticket to London .	Round-trip or one-way ?	When will you be arriving ?
DAILYDGRADE-000067	I don't know . But this is definitely the last straw .	Maybe you should start seeing someone else .	I ' m sorry , but I ' m not sure .
DAILYDGRADE-000068	Oh , I know a place where you might like to eat .	Is it close by ?	I think you ' re right .
DAILYDGRADE-000069	That sounds good . You order the beer while I go to the bathroom . Where is the can in this place ?	It's all the way to the back . See that yellow door ?	Yes , it ' s my first time .
DAILYDGRADE-000070	I think that's just steam . Your engine's overheated .	Do you know a lot about cars ?	No , I don ' t .
DAILYDGRADE-000071	Sorry . I was too worried .	I firmly believe that you love your brother very much .	Oh , I ' m sorry . I ' ve never heard about it .
DAILYDGRADE-000072	Not really . I don't think pop music has much depth .	I see what you mean . I think that's way I like it so much .	Really ? What ' s that ?
DAILYDGRADE-000073	Fine . I'll take the compact .	Alright . We have a blue Ford Focus for you , Mr . Fox . Would you like insurance ?	Yes , I ' d like to .
DAILYDGRADE-000074	Um , ninety-five dollars ?	Yes , that's the price they were advertising it at . I was hoping it might go on sale soon . Why , how much did you pay for it ?	Well , I think it ' s a little expensive .
DAILYDGRADE-000075	I went to Salt Lake City on business . What's up ?	I got fired .	Really ? Why ?
DAILYDGRADE-000076	Really ? Wow with who ?	This girl I've been chatting with for the past couple of months . She's really cool and she's driving over here this weekend .	Oh , I know . I ' ve heard that she ' s going to be a good thing .
DAILYDGRADE-000077	Why aren't you eating anything else ?	Well , fruits and vegetables are very healthy .	What kind of vegetables do you want to eat ?
DAILYDGRADE-000078	Lucky you ! I can't buy anything else . I'm flat broke .	I got a replace my party outfit , I trashed it last week .	You did a good one . It was a little hard on me .
DAILYDGRADE-000079	It is an exhibition of Chinese jades . It is held each year . A nice collection jades of are on display and sold .	Sounds great ! Can you stop somewhere here for a minute ? I will get some souvenirs for my friends .	Oh , I am really sorry . I have been looking forward to seeing you .
DAILYDGRADE-000080	Have you ever tried shopping online ?	No , never . I prefer to actually see and touch what I'm buying before I pay for it , especially for clothes and shoes .	What about the size ?
DAILYDGRADE-000081	How nice of him . I'll be delighted to go . But what time would be convenient ?	If you could be ready by , say 6:30 o'clock , I'll be at the hotel to pick you up .	That ' s fine .
DAILYDGRADE-000082	Barely . Will you be checking any luggage today ?	Yes , One suitcase . I also have a carry-on bag .	Do you have anything to declare ?
DAILYDGRADE-000083	I'm Du Juan , in Room 312 .	I see . Wait in the room , please .	OK .
DAILYDGRADE-000084	What do you feel about gay marriage ?	I think everyone has the right to love who they want .	They ' re really popular .
DAILYDGRADE-000085	The bartender just gave the last call . Let's order another round , okay ?	Sure , but let's get a pitcher this time We should be able to down it before they close .	That ' s good . I ' ll be there .
DAILYDGRADE-000086	How do you do ? Please be seated , How is your trip here ?	Quite good , I think . I came here by bus , and it took me about 15 minutes .	Really ?
DAILYDGRADE-000087	Does the class start again , Mam ?	Yes , but to the heath , this break has long enough .	Yes , but I have a lot of time .
DAILYDGRADE-000088	Sure ! Are you okay ? You seem a bit worried . What's on your mind ?	We need to talk .	I need to talk with you .
DAILYDGRADE-000089	Good afternoon ! Trans Pacific Airline . How can I help you ?	I'm calling to cancel my reservation for Trans Pacific Flight 8 on July 19 from Taipei to Minneapolis . Could you please make it for the same flight on August 2 instead of July 19 ?	Sure . I ' m afraid you can ' t .
DAILYDGRADE-000090	Have I got a high fever ?	Yes , thirty-eight point seven . Do you have a headache , chest or throat pain ?	No , I don ' t . I don ' t have a fever .
DAILYDGRADE-000091	That one truly is a beautiful piece of work , isn't it ?	One last question	Yes , I do .
DAILYDGRADE-000092	You'll need to make an appointment .	Could I do that right now , please ?	I ' m sorry . I can ' t .
DAILYDGRADE-000093	You get your bus pass ?	I'm not going to buy one .	How much do you want to get ?
DAILYDGRADE-000094	You're made a good choice . This china tea set is unusual .	Where was it from ?	It was great . But I didn ' t know you were in the middle of the tea .
DAILYDGRADE-000095	Well , you should come this weekend . I think you could do the climb .	Yeah , I will . See you then !	See you !
DAILYDGRADE-000096	Let me guess , from Sarah . It looks like something she would drive .	You guessed right . Besides , the color violet is a little girly for me .	What ?
DAILYDGRADE-000097	Ms . Wang , this is Mr . Cooper , president of Ivy Publishing .	It's nice to meet you , Mr . Cooper .	Yes , I ' m glad to hear you .
DAILYDGRADE-000098	Have you ever listened to AM radio ? It's quite a different experience than the traditional news stations on TV and FM radio .	I don't remember the last time I listened to AM radio .	But you should have a lot of money .
DAILYDGRADE-000099	It is too bad today .	What happened ?	It was a little accident .
DAILYDGRADE-000100	Hey Tina . What are you doing ?	I was just watching TV . What's going on with you ?	I ' m going to the movies .
DAILYDGRADE-000101	Here's my name card .	And here's mine .	Thank you .
DAILYDGRADE-000102	Thank you ! Would you like an aisle seat or a window seat ?	An aisle seat , please . I'm tall and need to get up and walk pretty often .	OK . I ' ll come back with you .
DAILYDGRADE-000103	Why doesn't he ask her ?	He is too scared to ask her .	But I don ' t know .
DAILYDGRADE-000104	What if I don't want to find another girl ?	You'll change your mind . Look at everyone in the world . They all break up and move on . The faster you understand this , the quicker you will recover .	Thank you .
DAILYDGRADE-000105	I'd like to speak Dr . Johnson .	Sorry , but he's not in . May I take a message for you ?	Yes , please .
DAILYDGRADE-000106	Well , known , Jim , I'm  .  .  .  I'm pretty much in favour of your computers , I think computers teach kids to think , because they require logical thoughts .	But I  .  .  .  I don't agree with thatbecause computers weaken kids'ability to thinkbecause kids don't learn basic skills .	What do you mean ?
DAILYDGRADE-000107	I have a lot of luggage . Will those fit in the taxi ?	Take it easy . I'll send a larger to pick you up .	Thank you .
DAILYDGRADE-000108	Anyway , the show is breathtaking . By the way , where did they get so much snow here ?	Well , they have the most advanced snowmaking machine .	Yes , they did .
DAILYDGRADE-000109	Nothing , Mummy . I was hungry so I came here for some milk .	Milk ? I thought you didn't like milk .	What about some of milk ?
DAILYDGRADE-000110	Please be at the airport two hours before your departure to check in . You also need to reconfirm your reservation with the airline at least 7 days prior to your departure .	What happens if I can't leave on April 13 ? Can I cancel my ticket or change the reservation to another date ?	No , you don ' t have to pay for your ticket .
DAILYDGRADE-000111	Thank you for your inition . I'm free tonight .	Which kind of food do you like , chinese food , western food or sea food ?	I like it .
DAILYDGRADE-000112	Yes . There have been a few there recently . They say that this one was not a big quake . The Iranians are dealing with it on their own . They have purchased some special equipment to find people buried u	Does the newspaper say anything about casualties ?	For example , the people are in the past two months , as the people are in the country , but not as bad as the government is highly competitive .
DAILYDGRADE-000113	Turn on the TV for what ?	So that we can sit down together and listen to some music .	Really ? What kind of music do you like ?
DAILYDGRADE-000114	Yes , I'd like a glass of iced tea .	Okay . I'll be back in a minute with your drink and salad .	Thank you .
DAILYDGRADE-000115	Wait a moment , please . Let me check it .	By the way , I want a large room .	Here you are .
DAILYDGRADE-000116	It was alright . I ran into Bill and we got to talking for a while . He's in a bit of a jam .	Why ? What happened ?	Well , he was a little accident .
DAILYDGRADE-000117	Providing warm meals and shelter , especially in the winter months . I found it really fulfilling to be part of that group .	I'm sure . Okay , now let's move on to your work experience , shall we ?	Yeah , why not ?
DAILYDGRADE-000118	Thank God ! I am finished writing that service guide ! It took me forever !	When did you finish ?	I had no time .
DAILYDGRADE-000119	What's the matter , John ? you seemed to be restless today .	You see , I've been offered a new job . I can't decide whether to take it or not .	Well , I ' ve got to say . I ' ve got a promotion .
DAILYDGRADE-000120	Look ! Mom , that's amazing ! I can't believe the girls have so neat movements .	Yeah , they all received very strict training . A minute on the stage takes ten-year practice .	Oh , no ! I see , you must have a lot of trouble with the pictures of the basketball team .
DAILYDGRADE-000121	Thank you .	What was your major in school ?	I was born in college .
DAILYDGRADE-000122	I didn't just find out about one job . There were several ones that looked good .	Maybe I should try looking on the web for work .	That ' s good .
DAILYDGRADE-000123	Good afternoon ! Trans Pacific Airline . How can I help you ?	I'm calling to cancel my reservation for Trans Pacific Flight 8 on July 19 from Taipei to Minneapolis . Could you please make it for the same flight on August 2 instead of July 19 ?	Sure . I ' m afraid you can ' t .
DAILYDGRADE-000124	The washer costs 50 cents and the dryer costs a dollar .	Where do I put the change ?	Do you need to change it for you ?
DAILYDGRADE-000125	I see . We will go the day after tomorrow .	By the way , what kind of stores do we need to go ?	OK . Let ' s go .
DAILYDGRADE-000126	Heard what ?	Deborah already had her baby .	Oh , what ?
DAILYDGRADE-000127	I suppose I don't want that one then . I don't like auto-reverse . It breaks too easily .	Really ? Have you had an auto-reverse break before ?	I don ' t know , but I don ' t know how to use it .
DAILYDGRADE-000128	How much per night are we talking about ?	Each night will be $ 308 .	$ 308 a night ?
DAILYDGRADE-000129	This is Bill Burton from Milford Insurance , I'm calling in regards to our meeting next Tuesday .	Thank you , Mr . Burton . Can you please hold for a moment ? I'll check to see if she is available .	OK .
DAILYDGRADE-000130	First of all , we'll design a custom-made work-out plan according to your habits .	How can you get that done ?	Well , I think we ' ll have a try .
DAILYDGRADE-000131	You can touch them only between the shoulder and the knees .	The touchdown lines are there and there . OK , let's play !	No kidding ! I don ' t think I can see it .
DAILYDGRADE-000132	I am not surprised , you eat too much .	And I suppose sitting at the desk all day in the office doesn't help .	Yes , I think I should go to find a place where you are .
DAILYDGRADE-000133	I would prefer next Thursday .	What time would be best for you ?	At 9 : 00 o ' clock .
DAILYDGRADE-000134	Yes .	What's the weather like in your country ?	It ' s very hot . The summers are very rainy .
DAILYDGRADE-000135	Don't feel like it . I'm broke .	Well , we can still do some window shopping , can we ?	I ' ll have to go to the hospital .
DAILYDGRADE-000136	I Like pop music best . Classical music is a bit too heavy for me . I can't get fully relaxed in it .	Pop music doesn't have any depth for me .	Oh , it ' s so interesting . I ' ve been to the past several years , I ' ve been to the movie , too .
DAILYDGRADE-000137	My appointment was on Monday .	What time had you chosen ?	I was waiting for my invitation .
DAILYDGRADE-000138	No . I am a transit passenger going to Sweden .	How long are you going to stay here ?	I have no idea .
DAILYDGRADE-000139	she said that the columnist for the literary criticism column would be going on pregnancy leave soon and that I could be in charge of the column until she came back .	wow ! That's really great news . How often does the magazine come out ?	The news is a very good idea .
DAILYDGRADE-000140	Can't beat that ! Thank you accounting guy !	The game starts at seven so we'd better hustle , it's already five .	I ' m sorry , but I ' m still waiting for the next one .
DAILYDGRADE-000141	Of course you do . They are silly stories just for little kids like you .	Don't call me kid . I am a grownup .	Really ? I am sorry .
DAILYDGRADE-000142	Not long , because people rush for lunch .	The line sure does move fast .	How much does it cost ?
DAILYDGRADE-000143	Bank of American card . The number is 6786 9182 12300 8657 .	Thank you ! Would you like an aisle seat or a window seat ?	I ' m afraid I can ' t .
DAILYDGRADE-000144	I'm forming a music band .	Do you already know how to play an instrument ?	Yeah , it ' s a good idea . You can play a musical instrument or so .
DAILYDGRADE-000145	Morning , Michael . I'Ve been very busy lately . One of our other vendors is going out of business and I'Ve been searching for a suitable replacement .	Well , rest assured that you can count on us to be here for the long run , sitdown . Coffee ?	No , I ' m afraid not . I ' m not interested in the spot .
DAILYDGRADE-000146	I am dying from the heat .	Turn on the air conditioner .	How long will it take ?
DAILYDGRADE-000147	That's how much this t . v costs .	That's too expensive for me .	I ' m not sure .
DAILYDGRADE-000148	Have you seen this news article ? Apparently an organization has made a list to name the new seven wonders of the world and people could vote for them online .	Wow , that's really interesting . So who won ?	It ' s a lot of people who give their skills .
DAILYDGRADE-000149	Yes , smoking or non-smoking ?	We'd like a non-smoking table , please .	Yes , please .
DAILYDGRADE-000150	yes , that's my only day off until Thursday .	ok , well , my friends and I are planning on going to the beach on Sunday . We tend to leave around noon whenever we go anywhere , so you could still sleep in . Do you want to come with us ?	Ok , well , my friends and I are planning on going to the beach on Sunday . We tend to leave around noon whenever we go anywhere , so you could still sleep in . Do you want to come with us ?
DAILYDGRADE-000151	Hello , 332440 .	Oh hello , Sally . This is Dave Thomson here . Could I speak to Jim please ?	Yes . He's in the line-up .
DAILYDGRADE-000152	If only our company prescribe flex time .	The board has been considering introducing flex time .	I'm wondering if you often trade with others on the internet .
DAILYDGRADE-000153	Thank you so much . Does he read his e-mails daily ?	Yes . He usually replies immediately .	He is afraid of his father-in-law .
DAILYDGRADE-000154	I'll take a little milk , but no sugar , please . Make sure you let the tea steep a few minutes before you take the tea bag out of the cup .	Ok . What do you think about our living room ?	It doesn't seem like that . Sorry , sir , we've tried everything , but we're not able to get it off the shirt . It was from the sugar I think .
DAILYDGRADE-000155	I want to take a look at that home with the Open House flags out front .	What a wonderful neighborhood ! Can you find that house on our Open House list ?	Yes , it looks perfect .
DAILYDGRADE-000156	Take it easy . We are going to have our own baby . You should be happy .	Yeah , I know .	I know , mom .
DAILYDGRADE-000157	Wow ! Your calligraphy is very beautiful . It was worth the wait !	Thank you . Today I'm writing a kind of poem called a Chinese couplet .	oh , she keeps saying that . She never allows me to have them .
DAILYDGRADE-000158	Anything wrong with it ?	Yes . When I spread it out back home , I found this hole .	You're right . Let's ask her to give us one more week .
DAILYDGRADE-000159	The service did not help the situation .	Is this a restaurant that you want to come back to ?	I went up there early this morning .
DAILYDGRADE-000160	Well , there will be charity performance on Saturday night . And also , there will be a solo concert by an opera star on Sunday night .	It's a good thing that I have choices here . Can you tell me about the one on Saturday ?	Sure , it's spelled Office and then D - E - P - O - T . It ' s in the Yellow Pages .
DAILYDGRADE-000161	What do you think about the equipment in our company ?	We have to equip our company with a network of work stations at every office and show room as soon as possible .	How do you ensure quality ?
DAILYDGRADE-000162	I shouted it back of course .	Hold it , Mike . You won't accomplish anything by hollering at him , right ? You worked it all up till now . Why not wait until you cool down a bit ?	well , I wish someone could talk to me about Western table manners
DAILYDGRADE-000163	What did they say ?	They said I need a new hard drive .	They're still fighting hard . Let ' s wait and see .
DAILYDGRADE-000164	That is right up my alley . You say party and I'm there .	Perfect . It will be open to the public and we anticipate roughly about five to seven hundred people .	Not until the 31st . So can you change the church reservations ?
DAILYDGRADE-000165	I can check that for you right now . Would you mind holding ?	Sure . No problem .	Is this a promise ?
DAILYDGRADE-000166	Oh , your precious game . You watch the same game every year , and each year your beloved hometown team loses by at least three goals !	Oh no you didn't . You didn't just insult the Sals-bury Seals , did you ? Why don't you just . just go and return all of those stupid clothes and not come back until the sales are over ?	Oh , your precious game . You watch the same game every year , and each year your beloved hometown team loses by at least three goals !
DAILYDGRADE-000167	I wasn't all that impressed by the food .	The service certainly could have been better .	It wasn't as good as you think .
DAILYDGRADE-000168	Me ? No way , keep him away from me , please .	Why are you acting so strange today ?	I just had a quarrel with him .
DAILYDGRADE-000169	Did you lend him a lot of money ?	Not much . I had to pay an unexpected bill , so I needed the money back .	not much . I had to pay an unexpected bill , so I needed the money back .
DAILYDGRADE-000170	Here you are .	Thanks . What kind of stone is this ?	It's C261 .
DAILYDGRADE-000171	Excuse me . Do you mind if I try this on ?	Not at all . The changing rooms are just this way .	That is all right .
DAILYDGRADE-000172	Well , it's specially made of a platinum alloy , sir , and the lustre will never fade out .	I'II take them . Please wrap them up tor me and give me the receipt .	All right . Here it is .
DAILYDGRADE-000173	That's for the phone calls you made from your room .	Can I pay with traveller's cheques ?	No , there's no charge for those .
DAILYDGRADE-000174	Yes , I have been working in the Public Relations Section of a company in the past two years . I plan the advertising campaign and cooperate the work of artists and typographers . Sometimes I have to do the work of a specialist when there's something urgent .	Do you have any practical experience as a secretary ?	First , I worked as a servant .
DAILYDGRADE-000175	How long will the induction training be ?	About two weeks .	Is the training center helpful ?
DAILYDGRADE-000176	Yeah , about .	Do you know Chinese better now ?	Just as usual , you know .
DAILYDGRADE-000177	Hum , Edward Norton , or something like that . Did you like him ?	Yes . He was excellent . They worked well together , don't you think ?	Yes . He was excellent . They worked well together .
DAILYDGRADE-000178	What sort of job would you like to take ?	I prefer a sedentary job and I used to work as an operator .	How ' d you get that job ?
DAILYDGRADE-000179	Yes , I'd like a book about law .	Would you tell me the name of the book and the author ?	Let me give you a hand . The author is ...
DAILYDGRADE-000180	I like the sound of that .	Yes , that is today's sale price .	Well , the sale price is $ 1 each .
DAILYDGRADE-000181	Good morning .	What does the paper say ?	It's 5:30 by my watch .
DAILYDGRADE-000182	All right , can I have your passbook ?	Yes , here you go .	All right . Now can I have your passbook ?
DAILYDGRADE-000183	I'm very sorry to hear that . May I have your name and room number , please ?	Yes , it's Yao Lan . Room 406 .	Mr . Lee in Room 1234 .
DAILYDGRADE-000184	I should tell you that I'm checking out in about 30 minutes .	I'm ready when you are , sir .	Please put your luggage outside your room by eight . The bellboy will pick them up .
DAILYDGRADE-000185	Hello ! How do I get more amenities ?	I'm sorry , sir . I'm not sure I understand .	I'm losing you , sir . What's the problem ?
DAILYDGRADE-000186	And they will yell back at you .	Yelling doesn't do any good .	I'm happy to help .
DAILYDGRADE-000187	The traffic is not very heavy on this high way , is it ? So I'm sure we'll make it .	No , but we'Ve got a hurry . It will be the rush hour soon .	We'll have to hurry ; visiting hours will be over soon
DAILYDGRADE-000188	What style do you want ?	I want to buy a V-neck checked sweater , and it should be tight .	It doesn't fit quite right . It feels a little tight in the waist . Do you have this in a larger size ?
DAILYDGRADE-000189	Mr . Smith , please .	Sorry , he is out .	Could you leave him a message ?
DAILYDGRADE-000190	Surely of course .	Here is the film . Can I get my pictures tomorrow ?	Yes , give me two rolls of Kodak color film .
DAILYDGRADE-000191	I need to stay home tonight and finish my term paper .	OK . What about going to the movies on Friday night ?	I ' d love to but I have to help John with his math problems right now .
DAILYDGRADE-000192	Let me check . Yes , we have .	May I try it on ?	You'd like it .
DAILYDGRADE-000193	And they're very dear , too .	They're on special offer today .	I wonder if they left it sitting around too long before they served it .
DAILYDGRADE-000194	You can't come any earlier than that ?	I'm sorry . That's the only available time .	I can't catch the bus with you anymore .
DAILYDGRADE-000195	Hello .	Hi . It's Tony calling from the dentist's office . Is Lily there ?	Yes , It's John eng .
DAILYDGRADE-000196	Excuse me . I have an appointment with Mr . Li at nine . May I come in ?	Yes , come in please . I am Mr . Li . You must be My Liu , right ?	I'm sorry , but he's not in the office now . Do you have an appointment ?
DAILYDGRADE-000197	You need a babysitter .	Yes , I'd ask Jill , the girl I've had before , but I need someone overnight . Maybe even for two nights .	You need a babysitter .
DAILYDGRADE-000198	What is it ? What happened ?	I think someone is stalking me .	No . Really , what happened ?
DAILYDGRADE-000199	What is it used for ? I mean , why bother to get this special account ?	Group companies can use this to make their arrangement of funds flexible , when dealing with their subsidiaries .	What kind of action is required ?
DAILYDGRADE-000200	The boss wanted to pay Bob with stock options . But Bob didn't want to play that game again .	Again ?	It's only seven minutes into the game , too early to cheer up .
DAILYDGRADE-000201	Shall we drop in somewhere for a couple of drinks ?	That sounds like a good idea .	OK . Shall we go to a bar ?
DAILYDGRADE-000202	Ah , some products are successful at home , but not be popular overseas .	That's because the fashion , taste and social customs and so on vary considerably .	Well I guess you have fewer characters but I think Chinese grammar is easier .
DAILYDGRADE-000203	How can you be so sure ?	I can tell form the way he spoke to us .	That doesn ' t make any sense .
DAILYDGRADE-000204	You know , I fell in love with this house the first moment I laid eyes on it .	The style of the exterior is just what I'Ve been looking for !	Well could you do me the favor of making this quick ? It ' s the third quarter and you ' Ve been blabbering on since the first !
DAILYDGRADE-000205	I want to go traveling .	Do you have any where in mind ?	There are student passes .
DAILYDGRADE-000206	Not bad .	Say I've got two tickets for the concert this evening . Would you like to come with me ?	Oh , I'd rather not .
DAILYDGRADE-000207	With everything , with everybody , with all this !	A good suggestion for you . You need a holiday .	A good suggestion for you . You need a holiday .
DAILYDGRADE-000208	Good afternoon . I come here specially to pick up my tickets . I booked it last month . This is my reservation note .	I am terribly sorry . You didn't come to reconfirm recently . You should have come to pick up your ticket three days ago since it's an international flight , any reservation without reconfirmation within 72 hours will be cancelled .	I understand . So that ' s one ticket to New York , and you ' ll be departing tonight . Will that be one-way or round trip ?
DAILYDGRADE-000209	Are these the clothes you want to have washed ?	Yes . When can I get them back ?	Or maybe make the beds .
DAILYDGRADE-000210	Exactly ! I searched on the web and found a couple of HMO's with low co-pays and good coverage . The deductibles are low , too .	Sounds good , although , do you think we can qualify for insurance ? Those insurance companies are real pirates when it comes to money .	Exactly ! I searched on the web and found a couple of HMO ' s with low co-pays and good coverage . The deductibles are low , too .
DAILYDGRADE-000211	Then tell me something about your background .	My major was computer science when I was at college , and I am quite familiar with Visual C + + and Java language .	What are you basing this information on ?
DAILYDGRADE-000212	Hi . What's your name ?	My name is Jung Min . What's your name ?	I'm an engineer at IBM .
DAILYDGRADE-000213	Great ! B , most of the items listed are available this year . I hope we can come to an agreement and sign the contracts , so as to enable our timely delivery .	That sounds good . But I have a proposal now .	It seems this is the only proposal for me to accept . I ' ll come again tomorrow to discuss it in detail .
DAILYDGRADE-000214	Why don't you watch where you're going ?	Me ? You're the one who pulled out in front of me !	Me ? You're the one who pulled out in front of me !
DAILYDGRADE-000215	How much is that one ?	It's two hundred and eighty dollars .	That's 20 dollars . Keep the change !
DAILYDGRADE-000216	I need to book a plane ticket to London .	Round-trip or one-way ?	Round trip or one way trip ?
DAILYDGRADE-000217	I don't know . But this is definitely the last straw .	Maybe you should start seeing someone else .	Yes . It could happen .
DAILYDGRADE-000218	Oh , I know a place where you might like to eat .	Is it close by ?	No , it's not far .
DAILYDGRADE-000219	That sounds good . You order the beer while I go to the bathroom . Where is the can in this place ?	It's all the way to the back . See that yellow door ?	It's all the way to the back . See that yellow door ?
DAILYDGRADE-000220	I think that's just steam . Your engine's overheated .	Do you know a lot about cars ?	I usually only have 2 beers .
DAILYDGRADE-000221	Sorry . I was too worried .	I firmly believe that you love your brother very much .	But I want you to be fit .
DAILYDGRADE-000222	Not really . I don't think pop music has much depth .	I see what you mean . I think that's way I like it so much .	not really . I don't think pop music has much depth .
DAILYDGRADE-000223	Fine . I'll take the compact .	Alright . We have a blue Ford Focus for you , Mr . Fox . Would you like insurance ?	Yes , I do . Do you accept American Express ?
DAILYDGRADE-000224	Um , ninety-five dollars ?	Yes , that's the price they were advertising it at . I was hoping it might go on sale soon . Why , how much did you pay for it ?	The price of CPU is 260 dollars above 1,000 Units .
DAILYDGRADE-000225	I went to Salt Lake City on business . What's up ?	I got fired .	Come on . Don ' t hesitate .
DAILYDGRADE-000226	Really ? Wow with who ?	This girl I've been chatting with for the past couple of months . She's really cool and she's driving over here this weekend .	Really ? That's really wonderful . I'm so happy for her .
DAILYDGRADE-000227	Why aren't you eating anything else ?	Well , fruits and vegetables are very healthy .	And vegetables with porridge .
DAILYDGRADE-000228	Lucky you ! I can't buy anything else . I'm flat broke .	I got a replace my party outfit , I trashed it last week .	yeah , maybe you ' re right . How about this outfit ?
DAILYDGRADE-000229	It is an exhibition of Chinese jades . It is held each year . A nice collection jades of are on display and sold .	Sounds great ! Can you stop somewhere here for a minute ? I will get some souvenirs for my friends .	We share the same desire . Have you seen the display of our products in the exhibition hall downstairs ?
DAILYDGRADE-000230	Have you ever tried shopping online ?	No , never . I prefer to actually see and touch what I'm buying before I pay for it , especially for clothes and shoes .	Why don't you go shopping online ?
DAILYDGRADE-000231	How nice of him . I'll be delighted to go . But what time would be convenient ?	If you could be ready by , say 6:30 o'clock , I'll be at the hotel to pick you up .	That's fine . I'll be waiting for you .
DAILYDGRADE-000232	Barely . Will you be checking any luggage today ?	Yes , One suitcase . I also have a carry-on bag .	Are you keeping this small bag as carry-on luggage , sir ?
DAILYDGRADE-000233	I'm Du Juan , in Room 312 .	I see . Wait in the room , please .	Could I have your name and room number ?
DAILYDGRADE-000234	What do you feel about gay marriage ?	I think everyone has the right to love who they want .	Would you make gay marriage legal ?
DAILYDGRADE-000235	The bartender just gave the last call . Let's order another round , okay ?	Sure , but let's get a pitcher this time We should be able to down it before they close .	The bartender just gave the last call . Let's order another round , okay ?
DAILYDGRADE-000236	How do you do ? Please be seated , How is your trip here ?	Quite good , I think . I came here by bus , and it took me about 15 minutes .	Wow , thanks a lot .
DAILYDGRADE-000237	Does the class start again , Mam ?	Yes , but to the heath , this break has long enough .	Yes , I mean it .
DAILYDGRADE-000238	Sure ! Are you okay ? You seem a bit worried . What's on your mind ?	We need to talk .	We need to talk .
DAILYDGRADE-000239	Good afternoon ! Trans Pacific Airline . How can I help you ?	I'm calling to cancel my reservation for Trans Pacific Flight 8 on July 19 from Taipei to Minneapolis . Could you please make it for the same flight on August 2 instead of July 19 ?	Yes there are . How do you want to go , First class or coach ?
DAILYDGRADE-000240	Have I got a high fever ?	Yes , thirty-eight point seven . Do you have a headache , chest or throat pain ?	No , but I have a low fever .
DAILYDGRADE-000241	That one truly is a beautiful piece of work , isn't it ?	One last question	It's fashionable .
DAILYDGRADE-000242	You'll need to make an appointment .	Could I do that right now , please ?	You need an appointment .
DAILYDGRADE-000243	You get your bus pass ?	I'm not going to buy one .	Is it fun driving the bus ?
DAILYDGRADE-000244	You're made a good choice . This china tea set is unusual .	Where was it from ?	Tea and silk .
DAILYDGRADE-000245	Well , you should come this weekend . I think you could do the climb .	Yeah , I will . See you then !	Well , you should come this weekend . I think you could do the climb .
DAILYDGRADE-000246	Let me guess , from Sarah . It looks like something she would drive .	You guessed right . Besides , the color violet is a little girly for me .	You guessed right . Besides , the color violet is a little girly for me ...
DAILYDGRADE-000247	Ms . Wang , this is Mr . Cooper , president of Ivy Publishing .	It's nice to meet you , Mr . Cooper .	It's nice to meet you , Mr . Cooper .
DAILYDGRADE-000248	Have you ever listened to AM radio ? It's quite a different experience than the traditional news stations on TV and FM radio .	I don't remember the last time I listened to AM radio .	Are you kidding ? Don't you know I can't swim ?
DAILYDGRADE-000249	It is too bad today .	What happened ?	It ' s been leaking for a couple of days now .
DAILYDGRADE-000250	Hey Tina . What are you doing ?	I was just watching TV . What's going on with you ?	I'm watching TV .
DAILYDGRADE-000251	Here's my name card .	And here's mine .	It's all yours .
DAILYDGRADE-000252	Thank you ! Would you like an aisle seat or a window seat ?	An aisle seat , please . I'm tall and need to get up and walk pretty often .	Anything but a center seat is fine with me . The middle seat drives me crazy !
DAILYDGRADE-000253	Why doesn't he ask her ?	He is too scared to ask her .	He is too scared to ask her .
DAILYDGRADE-000254	What if I don't want to find another girl ?	You'll change your mind . Look at everyone in the world . They all break up and move on . The faster you understand this , the quicker you will recover .	Right . Thanks .
DAILYDGRADE-000255	I'd like to speak Dr . Johnson .	Sorry , but he's not in . May I take a message for you ?	Yes . He's waiting for you in his office . This way , please .
DAILYDGRADE-000256	Well , known , Jim , I'm  .  .  .  I'm pretty much in favour of your computers , I think computers teach kids to think , because they require logical thoughts .	But I  .  .  .  I don't agree with thatbecause computers weaken kids'ability to thinkbecause kids don't learn basic skills .	But I ... I don't agree with that , because computers weaken kids ' ability to think , because kids don't learn basic skills .
DAILYDGRADE-000257	I have a lot of luggage . Will those fit in the taxi ?	Take it easy . I'll send a larger to pick you up .	By the way , don't forget your luggage on the ship .
DAILYDGRADE-000258	Anyway , the show is breathtaking . By the way , where did they get so much snow here ?	Well , they have the most advanced snowmaking machine .	No way , if it still has 21 .
DAILYDGRADE-000259	Nothing , Mummy . I was hungry so I came here for some milk .	Milk ? I thought you didn't like milk .	Why don't you get a new one ?
DAILYDGRADE-000260	Please be at the airport two hours before your departure to check in . You also need to reconfirm your reservation with the airline at least 7 days prior to your departure .	What happens if I can't leave on April 13 ? Can I cancel my ticket or change the reservation to another date ?	I think so . I won't forget anything important . As long as I have my passport , VISA card and airline ticket . It will be OK .
DAILYDGRADE-000261	Thank you for your inition . I'm free tonight .	Which kind of food do you like , chinese food , western food or sea food ?	Chinese food .
DAILYDGRADE-000262	Yes . There have been a few there recently . They say that this one was not a big quake . The Iranians are dealing with it on their own . They have purchased some special equipment to find people buried u	Does the newspaper say anything about casualties ?	Moving to to Latin American , Ecuador has suffered a six month drought that has not only affected farming , but has also forced the closure of the hydroelectric power plant that provides electricity for the entire country . In Chile , a major earthquake that registered seven point five on the Richter scale struck the southern region . Losses are reported to be in the billions . Authorities have not yet released an official statement .
DAILYDGRADE-000263	Turn on the TV for what ?	So that we can sit down together and listen to some music .	So that we can sit down together and listen to some music .
DAILYDGRADE-000264	Yes , I'd like a glass of iced tea .	Okay . I'll be back in a minute with your drink and salad .	All right . And would you like a salad ?
DAILYDGRADE-000265	Wait a moment , please . Let me check it .	By the way , I want a large room .	By the way , what's the rate for a single room ?
DAILYDGRADE-000266	It was alright . I ran into Bill and we got to talking for a while . He's in a bit of a jam .	Why ? What happened ?	It was alright . I ran into Bill and we got to talking for a while . He ' s in a bit of a jam .
DAILYDGRADE-000267	Providing warm meals and shelter , especially in the winter months . I found it really fulfilling to be part of that group .	I'm sure . Okay , now let's move on to your work experience , shall we ?	Providing warm meals and shelter , especially in the winter months . I found it really fulfilling to be part of that group .
DAILYDGRADE-000268	Thank God ! I am finished writing that service guide ! It took me forever !	When did you finish ?	About 2 o ' clock .
DAILYDGRADE-000269	What's the matter , John ? you seemed to be restless today .	You see , I've been offered a new job . I can't decide whether to take it or not .	But I don't know what else I can do . I am willing to work hard . Sometimes I make mistakes and the boss is not happy .
DAILYDGRADE-000270	Look ! Mom , that's amazing ! I can't believe the girls have so neat movements .	Yeah , they all received very strict training . A minute on the stage takes ten-year practice .	Tell me ! Tell me ! What's your secret ? !
DAILYDGRADE-000271	Thank you .	What was your major in school ?	I ' m going back to college .
DAILYDGRADE-000272	I didn't just find out about one job . There were several ones that looked good .	Maybe I should try looking on the web for work .	It seems that you can e-mail the seller and ask questions .
DAILYDGRADE-000273	Good afternoon ! Trans Pacific Airline . How can I help you ?	I'm calling to cancel my reservation for Trans Pacific Flight 8 on July 19 from Taipei to Minneapolis . Could you please make it for the same flight on August 2 instead of July 19 ?	Yes there are . How do you want to go , First class or coach ?
DAILYDGRADE-000274	The washer costs 50 cents and the dryer costs a dollar .	Where do I put the change ?	You need to put 50 cents into the washer machine and a dollar into the dryer .
DAILYDGRADE-000275	I see . We will go the day after tomorrow .	By the way , what kind of stores do we need to go ?	Half an hours later .
DAILYDGRADE-000276	Heard what ?	Deborah already had her baby .	You never guess she is going to have a baby .
DAILYDGRADE-000277	I suppose I don't want that one then . I don't like auto-reverse . It breaks too easily .	Really ? Have you had an auto-reverse break before ?	Yes , this price is very affordable , but driving this car you'll also notice a significant annual saving in gas consumption . The main attraction for this model is the fuel economy .
DAILYDGRADE-000278	How much per night are we talking about ?	Each night will be $ 308 .	$ 308 a night ? That's a fair price .
DAILYDGRADE-000279	This is Bill Burton from Milford Insurance , I'm calling in regards to our meeting next Tuesday .	Thank you , Mr . Burton . Can you please hold for a moment ? I'll check to see if she is available .	All right . I ' ll call you back later .
DAILYDGRADE-000280	First of all , we'll design a custom-made work-out plan according to your habits .	How can you get that done ?	About 2 days .
DAILYDGRADE-000281	You can touch them only between the shoulder and the knees .	The touchdown lines are there and there . OK , let's play !	is that why my knees have felt sore after every time I've ridden my bike ?
DAILYDGRADE-000282	I am not surprised , you eat too much .	And I suppose sitting at the desk all day in the office doesn't help .	No , I wouldn't think so .
DAILYDGRADE-000283	I would prefer next Thursday .	What time would be best for you ?	I would like to meet on Monday .
DAILYDGRADE-000284	Yes .	What's the weather like in your country ?	I love winter , I love snow .
DAILYDGRADE-000285	Don't feel like it . I'm broke .	Well , we can still do some window shopping , can we ?	Well , we can still do some window shopping , can't we ?
DAILYDGRADE-000286	I Like pop music best . Classical music is a bit too heavy for me . I can't get fully relaxed in it .	Pop music doesn't have any depth for me .	That is a perfect reason to like a certain kind of music .
DAILYDGRADE-000287	My appointment was on Monday .	What time had you chosen ?	It's Friday .
DAILYDGRADE-000288	No . I am a transit passenger going to Sweden .	How long are you going to stay here ?	Only four days .
DAILYDGRADE-000289	she said that the columnist for the literary criticism column would be going on pregnancy leave soon and that I could be in charge of the column until she came back .	wow ! That's really great news . How often does the magazine come out ?	She said that the columnist for the literary criticism column would be going on pregnancy leave soon and that I could be in charge of the column until she came back .
DAILYDGRADE-000290	Can't beat that ! Thank you accounting guy !	The game starts at seven so we'd better hustle , it's already five .	You mean half-and-half ?
DAILYDGRADE-000291	Of course you do . They are silly stories just for little kids like you .	Don't call me kid . I am a grownup .	Don't forger to come straight home after school .
DAILYDGRADE-000292	Not long , because people rush for lunch .	The line sure does move fast .	What kind of lease is it ?
DAILYDGRADE-000293	Bank of American card . The number is 6786 9182 12300 8657 .	Thank you ! Would you like an aisle seat or a window seat ?	Aisle , please .
DAILYDGRADE-000294	I'm forming a music band .	Do you already know how to play an instrument ?	Do you already know how to play an instrument ?
DAILYDGRADE-000295	Morning , Michael . I'Ve been very busy lately . One of our other vendors is going out of business and I'Ve been searching for a suitable replacement .	Well , rest assured that you can count on us to be here for the long run , sitdown . Coffee ?	Well , rest assured that you can count on us to be here for the long run , please sit down . Coffee ?
DAILYDGRADE-000296	I am dying from the heat .	Turn on the air conditioner .	Let's stand in the line now .
DAILYDGRADE-000297	That's how much this t . v costs .	That's too expensive for me .	That's how much this t . v costs .
DAILYDGRADE-000298	Have you seen this news article ? Apparently an organization has made a list to name the new seven wonders of the world and people could vote for them online .	Wow , that's really interesting . So who won ?	Yeah , I had been in the charity organization for 2 months and I learned a lot from that experience , including love , sympathy , equality , and so on .
DAILYDGRADE-000299	Yes , smoking or non-smoking ?	We'd like a non-smoking table , please .	Smoking or non-smoking ?
